WWWWWWWWWWWWWWWWWWWWWWWWWWWWWWWWWWWWWWWWWWWWWWWWWWW
WWWWWWWWWWWWWWWWWWWWWWWWWWWWWWWWWWWWWWWWWWWWWWWWWWW
SOOOOOOOOOOOOWWOOOOOOWWOOOOOOWWOOOOOOWWWWWWWWWWWWWW
SOOOOOOOOOOOOWWOOOOOOWWOOOOOOWWOOOOOOWWWWWWWWWWWWWW
WWWWWWWWWWWOOWWOOWWOOWWOOWWOOWWOOWWOOWWWWWWWWWWWWWW
WWWWWWWWWWWOOWWOOWWOOWWOOWWOOWWOOWWOOWWWWWWWWWWWWWW
WWWWWWWWWWWOOWWOOWWOOWWOOWWOOWWOOWWOOWWWWWWWWWWWWWW
WWWWWWWWWWWOOWWOOWWOOWWOOWWOOWWOOWWOOWWWWWWWWWWWWWW
WWWWWWWWWWWOOWWOOWWOOWWOOWWOOWWOOWWOOWWWWWWWWWWWWWW
WWWWWWWWWWWOOWWOOWWOOWWOOWWOOWWOOWWOOWWWWWWWWWWWWWW
WWWWWWWWWWWOOWWOOWWOOWWOOWWOOWWOOWWOOWWWWWWWWWWWWWW
WWWWWWWWWWWOOWWOOWWOOWWOOWWOOWWOOWWOOWWWWWWWWWWWWWW
WWWWWWWWWWWOOWWOOWWOOWWOOWWOOWWOOWWOOWWWWWWWWWWWWWW
WWWWWWWWWWWOOWWOOWWOOWWOOWWOOWWOOWWOOWWWWWWWWWWWWWW
WWWWWWWWWWWOOWWOOWWOOWWOOWWOOWWOOWWOOWWWWWWWWWWWWWW
WWWWWWWWWWWOOWWOOWWOOWWOOWWOOWWOOWWOOWWWWWWWWWWWWWW
WWWWWWWWWWWOOWWOOWWOOWWOOWWOOWWOOWWOOWWWWWWWWWWWWWW
WWWWWWWWWWWOOWWOOWWOOWWOOWWOOWWOOWWOOWWWWWWWWWWWWWW
WWWWWWWWWWWOOWWOOWWOOWWOOWWOOWWOOWWOOWWWWWWWWWWWWWW
WWWWWWWWWWWOOWWOOWWOOWWOOWWOOWWOOWWOOWWWWWWWWWWWWWW
WWWWWWWWWWWOOWWOOWWOOWWOOWWOOWWOOWWOOWWWWWWWWWWWWWW
WWWWWWWWWWWOOWWOOWWOOWWOOWWOOWWOOWWOOWWWWWWWWWWWWWW
WWWWWWWWWWWOOWWOOWWOOWWOOWWOOWWOOWWOOWWWWWWWWWWWWWW
WWWWWWWWWWWOOWWOOWWOOWWOOWWOOWWOOWWOOWWWWWWWWWWWWWW
WWWWWWWWWWWOOWWOOWWOOWWOOWWOOWWOOWWOOWWWWWWWWWWWWWW
WWWWWWWWWWWOOWWOOWWOOWWOOWWOOWWOOWWOOWWWWWWWWWWWWWW
WWWWWWWWWWWOOWWOOWWOOWWOOWWOOWWOOWWOOWWWWWWWWWWWWWW
WWWWWWWWWWWOOWWOOWWOOWWOOWWOOWWOOWWOOWWWWWWWWWWWWWW
WWWWWWWWWWWOOOOOOWWOOOOOOWWOOOOOOWWOOOOOOOOOOOOOOOE
WWWWWWWWWWWOOOOOOWWOOOOOOWWOOOOOOWWOOOOOOOOOOOOOOOE
WWWWWWWWWWWWWWWWWWWWWWWWWWWWWWWWWWWWWWWWWWWWWWWWWWW
WWWWWWWWWWWWWWWWWWWWWWWWWWWWWWWWWWWWWWWWWWWWWWWWWWW