WWWWWWWWWWWWWWWWWWWWWWWWWWWWWWWWWWWWWWWWWWWWWWWWWWW
OWWWWWWWWWWWWWWWWWWWWWWWWWWWWWWWWWWWWWWWWWWWWWWWWWW
SOOOOOOOOOOOOWWOOOOOOWWOOOOOOWWOOOOOOWWWWWWWWWWWWWW
SOOOOOOOOOOOOWWOOOOOOWWOOOOOOWWOOOOOOWWWWWWWWWWWWWW
OWWWWWWWWWWOOWWOOWWOOWWOOWWOOWWOOWWOOWWWWWWWWWWWWWW
WWWWWWWWWWWOOWWOOWWOOWWOOWWOOWWOOWWOOWWWWWWWWWWWWWW
WWWWWWWWWWWOOWWOOWWOOWWOOWWOOWWOOWWOOWWWWWWWWWWWWWW
WWWWWWWWWWWOOWWOOWWOOWWOOWWOOWWOOWWOOWWWWWWWWWWWWWW
WWWWWWWWWWWOOWWOOWWOOWWOOWWOOWWOOWWOOWWWWWWWWWWWWWW
WWWWWWWWWWWOOWWOOWWOOWWOOWWOOWWOOWWOOWWWWWWWWWWWWWW
WWWWWWWWWWWOOWWOOWWOOWWOOWWOOWWOOWWOOWWWWWWWWWWWWWW
WWWWWWWWWWWOOWWOOWWOOWWOOWWOOWWOOWWOOWWWWWWWWWWWWWW
WWWWWWWWWWWOOWWOOWWOOWWOOWWOOWWOOWWOOWWWWWWWWWWWWWW
WWWWWWWWWWWOOWWOOWWOOWWOOWWOOWWOOWWOOWWWWWWWWWWWWWW
WWWWWWWWWWWOOWWOOWWOOWWOOWWOOWWOOWWOOWWWWWWWWWWWWWW
WWWWWWWWWWWOOWWOOWWOOWWOOWWOOWWOOWWOOWWWWWWWWWWWWWW
WWWWWWWWWWWOOWWOOWWOOWWOOWWOOWWOOWWOOWWWWWWWWWWWWWW
WWWWWWWWWWWOOWWOOWWOOWWOOWWOOWWOOWWOOWWWWWWWWWWWWWW
WWWWWWWWWWWOOWWOOWWOOWWOOWWOOWWOOWWOOWWWWWWWWWWWWWW
WWWWWWWWWWWOOWWOOWWOOWWOOWWOOWWOOWWOOWWWWWWWWWWWWWW
WWWWWWWWWWWOOWWOOWWOOWWOOWWOOWWOOWWOOWWWWWWWWWWWWWW
WWWWWWWWWWWOOWWOOWWOOWWOOWWOOWWOOWWOOWWWWWWWWWWWWWW
WWWWWWWWWWWOOWWOOWWOOWWOOWWOOWWOOWWOOWWWWWWWWWWWWWW
WWWWWWWWWWWOOWWOOWWOOWWOOWWOOWWOOWWOOWWWWWWWWWWWWWW
WWWWWWWWWWWOOWWOOWWOOWWOOWWOOWWOOWWOOWWWWWWWWWWWWWW
WWWWWWWWWWWOOWWOOWWOOWWOOWWOOWWOOWWOOWWWWWWWWWWWWWW
WWWWWWWWWWWOOWWOOWWOOWWOOWWOOWWOOWWOOWWWWWWWWWWWWWW
WWWWWWWWWWWOOWWOOWWOOWWOOWWOOWWOOWWOOWWWWWWWWWWWWWO
WWWWWWWWWWWOOOOOOWWOOOOOOWWOOOOOOWWOOOOOOOOOOOOOOOO
WWWWWWWWWWWOOOOOOWWOOOOOOWWOOOOOOWWOOOOOOOOOOOOOOOO
WWWWWWWWWWWWWWWWWWWWWWWWWWWWWWWWWWWWWWWWWWWWWWWWWWO
WWWWWWWWWWWWWWWWWWWWWWWWWWWWWWWWWWWWWWWWWWWWWWWWWWW