WWWWWWWWWWWWWWWWWWWWWWWWWWWWWWWWWWWWWWWWWWWWWWWWWWW
WWWWWWWWWWWWWWWWWWWWWWWWWWWWWWWWWWWWWWWWWWWWWWWWWWW
WWWWWWWWWWWWWWWWWWWWWWWWWWWWWWWWWWWWWWWWWWWWWWWWWWW
WWWWWWWWWWWWWWWWWWWWWWWWWWWWWWWWWWWWWWWWWWWWWWWWWWW
WWWWWWWWWWWWWWWWOOOOOOOOOOWWWWWWWWWWWWWWWWWWWWWWWWW
WWWWWWWWWWWWWWWWOOOOOOOOOOWWWWWWWWWWWWWWWWWWWWWWWWW
WWWWWWWWWWWWWWWWOOWWWWWWOOWWWWWWWWWWWWWWWWWWWWWWWWW
WWWWWWWWWWWWWWWWOOWWWWWWOOWWWWWWWWWWWWWWWWWWWWWWWWW
WWWWWWWWWWWWWWWWOOWWWWWWOOWWWWWWWWWWWWWWWWWWWWWWWWW
WWWWWWWWWOOOOOOOOOWWWWWWOOOOOOOOOOWWWWWWWWWWWWWWWWW
WWWWWWWWWOOOOOOOOOWWWWWWOOOOOOOOOOWWWWWWWWWWWWWWWWW
WWWWWWWWWOOWWWWWWWWWWWWWWWWWWWWWOOWWWWWWWWWWWWWWWWW
WWWWWWWWWOOWWWWWWWWWWWWWWWWWWWWWOOWWWWWWWWWWWWWWWWW
WWWWWWWWWOOWWWWWWWWWWWWWWWWWWWWWOOWWWWWWWWWWWWWWWWW
WWWWWWWWWOOWWWWWWWWWWWWWWWWWWWWWOOWWWWWWWWWWWWWWWWW
WWWWWWWWWOOWWWWWWWWWWWWWWWWWWWWWOOWWWWWWWWWWWWWWWWW
WWWWWWWWWOOWWWWWWWWWWWWWWWWWWWWWOOWWWWWWWWWWWWWWWWW
WWWWWWWWWOOWWWWWWWWWWWWWWWWWWWWWOOOOOOOOOOOOOOOOOOE
WWWWWWWWWOOWWWWWWWWWWWWWWWWWWWWWOOOOOOOOOOOOOOOOOOE 
WWWWWWWWWOOWWWWWWWWWWWWWWWWWWWWWWWWWWWWWWWWWWWWWWWW
WWWWWWWWWOOWWWWWWWWWWWWWWWWWWWWWWWWWWWWWWWWWWWWWWWW
WWWWWWWWWOOWWWWWWWWWWWWWWWWWWWWWWWWWWWWWWWWWWWWWWWW
SOOOOOOOOOOWWWWWWWWWWWWWWWWWWWWWWWWWWWWWWWWWWWWWWWW
SOOOOOOOOOOWWWWWWWWWWWWWWWWWWWWWWWWWWWWWWWWWWWWWWWW
WWWWWWWWWWWWWWWWWWWWWWWWWWWWWWWWWWWWWWWWWWWWWWWWWWW
WWWWWWWWWWWWWWWWWWWWWWWWWWWWWWWWWWWWWWWWWWWWWWWWWWW
WWWWWWWWWWWWWWWWWWWWWWWWWWWWWWWWWWWWWWWWWWWWWWWWWWW
WWWWWWWWWWWWWWWWWWWWWWWWWWWWWWWWWWWWWWWWWWWWWWWWWWW
WWWWWWWWWWWWWWWWWWWWWWWWWWWWWWWWWWWWWWWWWWWWWWWWWWW
WWWWWWWWWWWWWWWWWWWWWWWWWWWWWWWWWWWWWWWWWWWWWWWWWWW
WWWWWWWWWWWWWWWWWWWWWWWWWWWWWWWWWWWWWWWWWWWWWWWWWWW
WWWWWWWWWWWWWWWWWWWWWWWWWWWWWWWWWWWWWWWWWWWWWWWWWWW