WWWWWWWWWWWWWWWWWWWWWWWWWWWWWWWWWWWWWWWWWWWWWWWWWWW
WWWWWWWWWWWWWWWWWWWWWWWWWWWWWWWWWWWWWWWWWWWWWWWWWWW
WWWWWWWWWWWWWWWWWWWWWWWWWWWWWWWWWWWWWWWWWWWWWWWWWWW
WWWWWWWWWWWWWWWWWWWWWWWWWWWWWWWWWWWWWWWWWWWWWWWWWWW
WWWWWWWWWWWWWWWWWWWWWWWWWWWWWWWWWWWWWWWWWWWWWWWWWWW
WWWWWWWWWWWWWWWWWWWWWWWWWWWWWWWWWWWWWWWWWWWWWWWWWWW
WWWWWWWWWWWWWWWWWWWWWWWWWWWWWWWWWWWWWWWWWWWWWWWWWWW
OOOWWWWWWWWWWWWWWWWWWWWWWWWWWWWWWWWWWWWWWWWWWWWWWWW
OOOOOOWWWWWWWWWWWWWWWWWWWWWWWWWWWWWWWWWWWWWWWWWWWWW
OOOOOOOOOWWWWWWWWWWWWWWWWWWWWWWWWWWWWWWWWWWWWWWWWWW
SOOOOOOOOOOOWWWWWWWWWWWWWWWWWWWWWWWWWWWWWWWWWWWWWWW
SOOOOOOOOOOOOOOWWWWWWWWWWWWWWWWWWWWWWWWWWWWWWWWWWWW
OOOOOOOOOOOOOOOOOOWWWWWWWWWWWWWWWWWWWWWWWWWWWWWWWWO
OOOOOOOOOOOOOOOOOOOOOWWWWWWWWWWWWWWWWWWWWWWWWWWWWOO
OOOOOOOOOOOOOOOOOOOOOOOOWWWWWWWWWWWWWWWWWWWWWWWWOOO
OOOOOOOOOOOOOOOOOOOOOOOOOOOOOOOOOOOOOOOOOOOOOOOOOOO
OOOOOOOOOOOOOOOOOOOOOOOOWWWWWWWWWWWWWWWWWWWWWWWWOOO
OOOOOOOOOOOOOOOOOOOOOWWWWWWWWWWWWWWWWWWWWWWWWWWWWOO
OOOOOOOOOOOOOOOOOOWWWWWWWWWWWWWWWWWWWWWWWWWWWWWWWWO
OOOOOOOOOOOOOOOWWWWWWWWWWWWWWWWWWWWWWWWWWWWWWWWWWWW
OOOOOOOOOOOOWWWWWWWWWWWWWWWWWWWWWWWWWWWWWWWWWWWWWWW
OOOOOOOOOWWWWWWWWWWWWWWWWWWWWWWWWWWWWWWWWWWWWWWWWWW
OOOOOOWWWWWWWWWWWWWWWWWWWWWWWWWWWWWWWWWWWWWWWWWWWWW
OOOWWWWWWWWWWWWWWWWWWWWWWWWWWWWWWWWWWWWWWWWWWWWWWWW
WWWWWWWWWWWWWWWWWWWWWWWWWWWWWWWWWWWWWWWWWWWWWWWWWWW
WWWWWWWWWWWWWWWWWWWWWWWWWWWWWWWWWWWWWWWWWWWWWWWWWWW
WWWWWWWWWWWWWWWWWWWWWWWWWWWWWWWWWWWWWWWWWWWWWWWWWWW
WWWWWWWWWWWWWWWWWWWWWWWWWWWWWWWWWWWWWWWWWWWWWWWWWWW
WWWWWWWWWWWWWWWWWWWWWWWWWWWWWWWWWWWWWWWWWWWWWWWWWWW
WWWWWWWWWWWWWWWWWWWWWWWWWWWWWWWWWWWWWWWWWWWWWWWWWWW
WWWWWWWWWWWWWWWWWWWWWWWWWWWWWWWWWWWWWWWWWWWWWWWWWWW
WWWWWWWWWWWWWWWWWWWWWWWWWWWWWWWWWWWWWWWWWWWWWWWWWWW