WWWWWWWWWWWWWWWWWWWWWWWWWWWWWWWWWWWWWWWWWWWWWWWWWWW
WWWWWWWWWWWWWWWWWWWWWWWWWWWWWWWWWWWWWWWWWWWWWWWWWWW
WWWWWWWWWWWWWWWWWWWWWWWWWWWWWWWWWWWWWWWWWWWWWWWWWWW
WWWWWWWWWWWWWWWWWWWWWWWWWWWWWWWWWWWWWWWWWWWWWWWWWWW
WWWWWWWWWWWWWWWWWWWWWWWWWWWWWWWWWWWWWWWWWWWWWWWWWWW
WWWWWWWWWWWWWWWWWWWWWWWWWWWWWWWWWWWWWWWWWWWWWWWWWWW
WWWWWWWWWWWWWWWWWWWWWWWWWWWWWWWWWWWWWWWWWWWWWWWWWWW
WWWWWWWWWWWWWWWWWWWWWWWWWWWWWWWWWWWWWWWWWWWWWWWWWWW
WWWWWWWWWWWWWWWWWWWWWWWWWWWWWWWWWWWWWWWWWWWWWWWWWWW
WWWWWWWWWOOOOOOOOOOOOOOOOOOOOOOOOOWWWWWWWWWWWWWWWWW
WWWWWWWWWOOOOOOOOOOOOOOOOOOOOOOOOOWWWWWWWWWWWWWWWWW
WWWWWWWWWOOWWWWWWWWWWWWWWWWWWWWWOOWWWWWWWWWWWWWWWWW
WWWWWWWWWOOWWWWWWWWWWWWWWWWWWWWWOOWWWWWWWWWWWWWWWWW
WWWWWWWWWOOWWWWWWWWWWWWWWWWWWWWWOOWWWWWWWWWWWWWWWWW
WWWWWWWWWOOWWWWWWWWWWWWWWWWWWWWWOOWWWWWWWWWWWWWWWWW
WWWWWWWWWOOWWWWWWWWWWWWWWWWWWWWWOOWWWWWWWWWWWWWWWWW
WWWWWWWWWOOWWWWWWWWWWWWWWWWWWWWWOOWWWWWWWWWWWWWWWWW
WWWWWWWWWOOWWWWWWWWWWWWWWWWWWWWWOOOOOOOOOOOOOOOOOOE
WWWWWWWWWOOWWWWWWWWWWWWWWWWWWWWWOOOOOOOOOOOOOOOOOOE 
WWWWWWWWWOOWWWWWWWWWWWWWWWWWWWWWWWWWWWWWWWWWWWWWWWW
WWWWWWWWWOOWWWWWWWWWWWWWWWWWWWWWWWWWWWWWWWWWWWWWWWW
WWWWWWWWWOOWWWWWWWWWWWWWWWWWWWWWWWWWWWWWWWWWWWWWWWW
SOOOOOOOOOOWWWWWWWWWWWWWWWWWWWWWWWWWWWWWWWWWWWWWWWW
SOOOOOOOOOOWWWWWWWWWWWWWWWWWWWWWWWWWWWWWWWWWWWWWWWW
WWWWWWWWWWWWWWWWWWWWWWWWWWWWWWWWWWWWWWWWWWWWWWWWWWW
WWWWWWWWWWWWWWWWWWWWWWWWWWWWWWWWWWWWWWWWWWWWWWWWWWW
WWWWWWWWWWWWWWWWWWWWWWWWWWWWWWWWWWWWWWWWWWWWWWWWWWW
WWWWWWWWWWWWWWWWWWWWWWWWWWWWWWWWWWWWWWWWWWWWWWWWWWW
WWWWWWWWWWWWWWWWWWWWWWWWWWWWWWWWWWWWWWWWWWWWWWWWWWW
WWWWWWWWWWWWWWWWWWWWWWWWWWWWWWWWWWWWWWWWWWWWWWWWWWW
WWWWWWWWWWWWWWWWWWWWWWWWWWWWWWWWWWWWWWWWWWWWWWWWWWW
WWWWWWWWWWWWWWWWWWWWWWWWWWWWWWWWWWWWWWWWWWWWWWWWWWW