WWWWWWWWWWWWWWWWWWWWWWWWWWWWWWWWWWWWWWWWWWWWWWWWWWW
WWWWWWWWWWWWWWWWWWWWWWWWWWWWWWWWWWWWWWWWWWWWWWWWWWW
WWWWWWWWWWWWWWWWWWWWWWWWWWWWWWWWWWWWWWWWWWWWWWWWWWW
WWWWWWWWWWWWWWWWWWWWWWWWWWWWWWWWWWWWWWWWWWWWWWWWWWW
WWWWWWWWWWWWWWWWOOOOOOOOOOWWWWWWWWWWWWWWWWWWWWWWWWW
WWWWWWWWWWWWWWWWOOOOOOOOOOWWWWWWWWWWWWWWWWWWWWWWWWW
WWWWWWWWWWWWWWWWOOWWWWWWOOWWWWWWWWWWWWWWWWWWWWWWWWW
WWWWWWWWWWWWWWWWOOWWWWWWOOWWWWWWWWWWWWWWWWWWWWWWWWW
WWWWWWWWWWWWWWWWOOWWWWWWOOWWWWWWWWWWWWWWWWWWWWWWWWW
WWWWWWWWWOOOOOOOOOWWWWWWOOOOOOOOOOWWWWWWWWWWWWWWWWW
WWWWWWWWWOOOOOOOOOWWWWWWOOOOOOOOOOWWWWWWWWWWWWWWWWW
WWWWWWWWWOOWWWWWWWWWWWWWWWWWWWWWOOWWWWWWWWWWWWWWWWW
WWWWWWWWWOOWWWWWWWWWWWWWWWWWWWWWOOWWWWWWWWWWWWWWWWW
WWWWWWWWWOOWWWWWWWWWWWWWWWWWWWWWOOWWWWWWWWWWWWWWWWW
WWWWWWWWWOOWWWWWWWWWWWWWWWWWWWWWOOWWWWWWWWWWWWWWWWW
WWWWWWWWWOOWWWWWWWWWWWWWWWWWWWWWOOWWWWWWWWWWWWWWWWW
WWWWWWWWWOOWWWWWWWWWWWWWWWWWWWWWOOWWWWWWWWWWWWWWWWO
WWWWWWWWWOOWWWWWWWWWWWWWWWWWWWWWOOOOOOOOOOOOOOOOOOO
WWWWWWWWWOOWWWWWWWWWWWWWWWWWWWWWOOOOOOOOOOOOOOOOOOO 
WWWWWWWWWOOWWWWWWWWWWWWWWWWWWWWWWWWWWWWWWWWWWWWWWWO
WWWWWWWWWOOWWWWWWWWWWWWWWWWWWWWWWWWWWWWWWWWWWWWWWWW
OWWWWWWWWOOWWWWWWWWWWWWWWWWWWWWWWWWWWWWWWWWWWWWWWWW
SOOOOOOOOOOWWWWWWWWWWWWWWWWWWWWWWWWWWWWWWWWWWWWWWWW
SOOOOOOOOOOWWWWWWWWWWWWWWWWWWWWWWWWWWWWWWWWWWWWWWWW
OWWWWWWWWWWWWWWWWWWWWWWWWWWWWWWWWWWWWWWWWWWWWWWWWWW
WWWWWWWWWWWWWWWWWWWWWWWWWWWWWWWWWWWWWWWWWWWWWWWWWWW
WWWWWWWWWWWWWWWWWWWWWWWWWWWWWWWWWWWWWWWWWWWWWWWWWWW
WWWWWWWWWWWWWWWWWWWWWWWWWWWWWWWWWWWWWWWWWWWWWWWWWWW
WWWWWWWWWWWWWWWWWWWWWWWWWWWWWWWWWWWWWWWWWWWWWWWWWWW
WWWWWWWWWWWWWWWWWWWWWWWWWWWWWWWWWWWWWWWWWWWWWWWWWWW
WWWWWWWWWWWWWWWWWWWWWWWWWWWWWWWWWWWWWWWWWWWWWWWWWWW
WWWWWWWWWWWWWWWWWWWWWWWWWWWWWWWWWWWWWWWWWWWWWWWWWWW